12 09 00 12 05 05 09 12 05 01 
10 10 12 03 12 05 03 10 12 01 
10 06 03 00 10 12 01 10 02 08 
10 12 09 08 10 06 05 03 00 10 
10 10 10 02 06 09 08 12 09 10 
10 10 10 12 09 10 10 10 10 10 
10 02 10 10 06 03 02 10 06 03 
06 09 10 10 12 05 05 03 12 09 
08 10 10 06 03 08 12 05 03 10 
06 03 06 05 05 03 02 04 05 03 
